{
	"width": 26,
	"height": 18,
	"scale": 25,
	
	"layout": [ "..........................",
				"............XX..........G.",
				"...........XXXX...........",
				"...........XXXX...........",
				"............XX............",
				"..........................",
				"..........................",
				"..........................",
				"..........................",
				"..........................",
				"..........................",
				"..........................",
				"....XX....................",
				"...XXXX...................",
				"...XXXX...................",
				"....XX....................",
				".S........................",
				".........................." ]
}